haywire
In hindsight - Patrząc z perspektywy czasu
confided in - ufac
pretend
tend to job
Up until then she was - do tamtego momentu
on the whole - ogólnie rzecz biorąc \
drown drawn
boat - łódź
fall out of - wypasc \
fell out of 
and anon they separated. ??? \
not much - nie za bardzo
be in contact
politician  |ˌpɑːləˈtɪʃn| - polityk

hold of the rules
bary us
vary  |ˈveri| - wahać się
make a point -  wysuwać propozycję
make one's point
automatically  |ˌɔːtəˈmætɪkli| - automatycznie
fire up the app - odpalić apkę / 
retrieve the address - odnaleźć adres 
Grab the content of the variable
whereas  |ˌwerˈæz| - podczas gdy

senior  |ˈsiːniər| - osoba starsza, senior \
get along fine \
make fun of - śmiać się z 
In point of fact = in fact \
I’m very fond of \
I always got on well with = radzić sobie z  \
get straight to the point = przejść od razu do rzeczy \
ever since I first saw you = od kiedy tylko \
For the first time = po raz pierwszy \
to confide in someone = zwierzyć się komuś \
it means in turn = z kolei \
establish contact with sb = nawiązać kontakt
strictly speaking = ściśle rzecz biorąc \
 reliable  |rɪˈlaɪəbl| - niezawodny \
presence  |ˈprezns| - obecność
on her conditions = na jej warunkach
approximately - około
velocity  |vəˈlɑːsəti| - szybkość \

quantity  |ˈkwɑːntəti| - ilość
quantities of beer
glare |ɡler|  - blask
grip  |ɡrɪp| - uchwyt
 keep everyone up to date on our progress
casual  |ˈkæʒuəl| - przypadkowy
during a one year period  |ˈpɪriəd| - okres
get a grip on - mieć kontrole nad
have control over her own life - mieć kontrole nad
custody  |ˈkʌstədi| - opieka
appreciably  |əˈpriːʃəbli| - w znaczącym stopniu
appreciably  |əˈpriːʃəbli| - znacznie
She no longer felt - już nie
to please - zadowolić kogoś
most often - najczęściej
to glare at smb |ɡler| - patrzeć na
hanging out together = spędzając razem czas
she hung out with
through sb she became - przez kogoś
consist of - składać się z 
They also lived up to their name = zgodnie z 
fringe  |frɪndʒ| - obrzeże
on the fringe of the group = na marginesie grupy
contribute to |kənˈtrɪbjuːt| - wnosić wkład do
+ przyczyniać się do
clothing  |ˈkloʊðɪŋ| - odzież
marking time = waste a time
going nowhere.
have fun = bawić się
, by extension,  = i jak wynik 
stand up for her = stanąć w jej obronie /
at any other time — в любое другое время
pole votes
 It is assumed that = zakłada się , że 
 primer = podręcznik dla początkujących American English
Can you recommend me a primer on this subject?
start at the beginning = od początku
bear  |ber| - wytrzymać \
to keep track of  =  śledzić kogoś \
positions are always given in meters
 we've gone over the basics of - przeszlismy sie po 
 i need to - muszę \
  the most common = najczęstszy \
  One of the most common applications = zastosowan
  axis  |ˈæksɪs| - oś \
  frame  |freɪm| - kadr - w fotografii
to fit your hair into the frame = zmieścić coś
by hand = ręcznie \
subtraction  |səbˈtrækʃn| - odejmowanie
wrap your mind around these concepts
length  |leŋθ| - długość
magnitude of the vector  |ˈmæɡnɪtuːd| - wielkość, ogrom
hypotenuse  |haɪˈpɑːtənuːs| - hipoteneza
theorem  |ˈθiːərəm| - twierdzenie matematyczne, teoremat \
opposed  |əˈpoʊzd| - przeciwny
as opposed to = w przeciwieństwie do \
what is it good for? - po co to? \
I am opposed to you marry him = przeciwny  \
normalized  |ˈnɔːrməˌlaɪzd| - normalny
We can call this “x raised to the power of n,” “x to the power of n,” or simply “x to the n.”

substitute |ˈsʌbstɪtuːt| - zastąpić
smth substitute for smth - zastąpić
simplify  |ˈsɪmplɪfaɪ| - uprościć /
decimal  |ˈdesɪml| - dziesiętny / 
deaf  |def| - głuchy / 

Many women sacrifice their career for their family
needless  |ˈniːdləs| - zbędny
sacrifice  |ˈsækrɪfaɪs| - poświęcenie, poświęcać
announcement  |əˈnaʊnsmənt| - ogłoszenie \
make an announcement - anancowac
with care - ostroznie
how to deal with sb - poradzic z 
except you - oprócz, save \
you musn't - nie wolno ci \
before everything - ponad wszystko
take a letter - napisać list
citizenship - obywatelstwo
fired - zwolniony

suggest  |səˈdʒest| - proponować
make a suggestion = suggest

devote a time 
sacrifice a time

for a long time - od dłuższego czasu
deliberate  |dɪˈlɪbərət| - zastanawiać się
apart  |əˈpɑːrt| - osobno
have the clue - mieć pojęcie
have no clue - nie mieć pojęcią
But they had no clue that
Apart from that, - poza tym
turn to sb - zwrócić się do kogoś
She deliberated for a long time - zastanawiała się
grope - obmacywać
one time - jeden raz
no ill intentions - zamiarów
beliefs - przekonania
grain  |ɡreɪn| - ziarno
go against the grain = robić coś przeciwko swoim przekonaniom 
debt  |det| - dług, zadłużenie \
it would put her in his debt
how her life would take shape - jak ułoży się życie 
instead of - zamiast \
take the assignment = podjąć się zadania \

task = assignment
smother  |ˈsmʌðər| - udusić
regarded herself as a victim - uważać siebie za
 had to get up early in the morning even though it was Sunday.
 even thought - mimo że \
victim  |ˈvɪktɪm| - ofiara \
remaining option = pozostała opcja
take matters in her own hands = bierze sprawy w swoje ręce \
solve her problems on her own = rozwiązywać swoje problemy na własną rękę
bode  |boʊd| - 
it did not bode well for Herr Advokat = to nie wróżyło dobrze Herr Advokatowi
are you mind77 - normalny777
every time you want
get over it = pokonac to \
want  |wɑːnt| - chcieć
shrink me
have wronh idea about him mylisz sie o nim

radius  |ˈreɪdiəs| - [mat.] promień \
equation  |ɪˈkweɪʒn| - [mat.] równanie
these are the bare bones of - na tym polega sens \
practical use of - praktyczne zastosowanie ... \
column  |ˈkɑːləm| - kolumna \
reciprocal  |rɪˈsɪprəkl| - dwustronny, wzajemny
 be right - być poprawnym
 cross  |krɔːs| - krzyż / skrzyżować
product  |ˈprɑːdʌkt| - iloczyn – wynik mnożenia
Cross Product" (also see Dot Product) - vector's multiplication
dimension  |daɪˈmenʃn| - wymiar
origin point  = (0,0,0)
Unit Vector = a^ (1, 1, 1)
likewise  |ˈlaɪkwaɪz| - rowniez / 


208
thorough  |ˈθɜːroʊ| - gruntowny, szczegółowy
sharpen  |ˈʃɑːrpən| - poprawić coś, polepszyć
contribute  |kənˈtrɪbjuːt| - wnosić wkład \
lay her hands on \
finance  |ˈfaɪnæns| - finanse
upbringing  |ˈʌpbrɪŋɪŋ| - wychowanie \
reputation was spotless
accused  |əˈkjuːzd| - oskarżony
he donated money - przekazać money
although  |ɔːlˈðoʊ| - chociaż \
apparently  |əˈpærəntli| - najwyraźniej
happily  |ˈhæpɪli| - szczęśliwie
dispute  |dɪˈspjuːt| - spór
exploit  |ɪkˈsplɔɪt| - wykorzystywać
probe  |proʊb| - badać
there was no sign of it
hitherto  |ˌhɪðərˈtuː| - dotąd, dotychczas
anonymous  |əˈnɑːnɪməs| - anonimowy
she gathered up smth- zebrała
beyond reproach - bez zarzutu
reproach  |rɪˈproʊtʃ| - zarzut \
She knew beyond a doubt that - bez wątpienia
catch  |kætʃ| - pułapka, łapać \
The catch was that - Подвох в том, что
= haczyk polega na tym, że \
 carry on - kontynuować \

express  |ɪkˈspres| - ekspresowy
benefit  |ˈbenɪfɪt| - korzyść czegoś \
scale up the containers
even though - mimo że
bring up the subject - poruszac temat \
point out - zwracać uwagę na 
I would like to point out how important she is to us
swarm  |swɔːrm| - rój
snapshot
robust  |roʊˈbʌst| - solidny, silny
put together - link smth with smth
at the end of the day - w końcu
merely  |ˈmɪrli| - jedynie, zaledwie
multiple  |ˈmʌltɪpl| - wielu
interact with  |ˌɪntərˈækt| 
to do so we need to ........
be cristal clear
solely - wyłącznie, jedynie 
assemble  |əˈsembl| - złożyć coś z części
compose  |kəmˈpoʊz| - komponować, tworzyć
alpine  |ˈælpaɪn| - narciarstwo zjazdowe/alpejskie
at this point  - w tym momencie, na tym etapie (w 
He felt torn - rozdarty \
pry into - wścibiać nos w coś
mistreate - źle traktować
usual  |ˈjuːʒuəl| - zwykły \
defend - bronić
I made sure he was fired - upewnić się w 
demise  |dɪˈmaɪz| - śmierć
consider  |kənˈsɪdər| - rozważać
scenarios  |sɪˈnɑːrɪoʊz| - scenariusz
choose (chose) 
ack on impulse
perpetrator  - sprawca
reject an option |rɪˈdʒekt| - odrzucać
awfully good at - okropnie 
provoke a struggle - sprowokować walkę
passersby  |ˈpæsərzbi| - 
she settled on poison.
choice
and thus
cram new material into his head - wbić do 
shop for groceries
do his laundry
laundry  |ˈlɔːndri| - pralnia
go into city \
patiently  - pacjent \
patient  |ˈpeɪʃnt| - pacjent
be pointless - być bezcelwym \
precisely  |prɪˈsaɪsli| - dokładnie! \
upon  |əˈpɑːn| - po, z chwilą
Upon hearing this news - po 
courage  |ˈkɜːrɪdʒ| - odwaga
uglier  |ˈʌɡliər| - brzydszy


sighed  |ˈsaɪd| - Westchnęła głęboko.
broadened my mind
broaden  |ˈbrɔːdn| - rozszerzać \
broaden my mind - poszerzać swoje horyzonty  \
most recent - najnowszy \
with the excuse that - pod pretekstem
allowance  |əˈlaʊəns| - kieszenkowe
unfamiliar  |ˌʌnfəˈmɪliər| - nieznany, nieznajomy, obcy
the meething was set for fryday
she was given - he gived
sharpen  |ˈʃɑːrpən| - naostrzyć
give , gave ,given
beyond the house - za domem
accessory  |əkˈsesəri| - akcesoryjny, dodatkowy
above all - przede wszystkim \
the plan went wrong
functioned as a bedside table - służy jako \
take by the hand
resist  |rɪˈzɪst| - powstrzymać coś 
is grip on her chin
chin  |tʃɪn| - broda, podbródek
pull toward the bed
to talk sense into him - przemówić do rozsądku
to talk the time - pilnować czas?
threw on the bed (throw)
straddle  |ˈstrædl| - 
like the time before - jak poprzednim razem \
gone  |ɡɔːn| - nieobecny, stracony, taki, którego już nie ma
rip off - rozerwać coś \
terrify  |ˈterɪfaɪ| - przerażać, zatrważać \
handcuffs  |ˈhændˌkʌfs| - kajdanki \ 
close around - w pobliżu \
to pull off her boots - zdjąć coś 
knickers  |ˈnɪkərz| - majtki (z nogawkami)
stuffed the knickers in her mouth - wepchnąć
stuff smth in  \
spread her legs - rozłożyć
vulnerable  |ˈvʌlnərəbl| - bezbronny
she heard him - one słyszała jak on 
clothes  |kloʊðz| - odzież
nod  |nɑːd| - skinąć głową \
constraint  |kənˈstreɪnt| - ograniczenie
distinct  |dɪˈstɪŋkt| - odrębny, różny
span \
resume - ponowić
resume  |rɪˈzuːm| - wznowić
perspire  |pərˈspaɪər| - pocić się \
shotdown  - 

be thrown away - być wyrzuconym
pride  |praɪd| - duma
tighten  |ˈtaɪtn| -  zacisnąć
grip  |ɡrɪp| - uścisk \
abdomen  |ˈæbdəmən| - brzuch
wound  |wuːnd| - rana \
heal  |hiːl| - zagoić się \
misjudge - błednie ocenić
utterly  |ˈʌtərli| - całkowicie \
he meant - mieć zamiar, mieć na myśli
at one point - w pewnym momencie
shed tears  |ʃed| - uronić łzy
With difficulty - z trudem
did not feel like - nie mieć ochoty
tuesday  |ˈtuːzdeɪ| - wtorek
on the Internet
dependence  |dɪˈpendəns| - zależność
parlour  |ˈpɑːrlər| - salon, zakład
recognize  |ˈrekəɡnaɪz| - rozpoznać
depict  |dɪˈpɪkt| - przedstawiać
beets  |ˈbiːts| - burak \
country  |ˈkʌntri| - wieś \
stay (stood) by - stać obok
around - około (jakiejś godziny)
It did not seem likely that - to małoprawd to że
He glanced at the little TV - spojrzać na 
returned at the agreed - w uzgodnionym terminie
rough  |rʌf| - szorstki, chropowaty, nierówny
subdued  |səbˈduːd| - przytłumiony, przyćmiony
be amiss  |əˈmɪs| - źle, nie w porządku
armpit  |ˈɑːrmpɪt| - pacha
developed into - zamieniwała się w 
unnoticed  |ˌʌnˈnoʊtɪst| - nie zauważony
reckless  |ˈrekləs| - brawurowy, szaleńczy, lekkomyślny
put the book down
banal
abuse  |əˈbjuːs| - nadużycie
She had become used to it. - przyzwyczaić się 
to see through - wydzieć prawdę
berate  |bɪˈreɪt| - 
muscles  |ˈmʌsəlz| - mięśnie
His muscles were no use to him


paralysed  |ˈpærəlaɪzd| - sparaliżowany
disoriented  |ˌdɪˈsɔːriˌentəd| - 
regain  |rɪˈɡeɪn| - odzyskać 
regain control over my body
seal  |siːl| - zakleić
sealed  |ˈsiːld| - zaklejony
whip  |wɪp| - bat
heap  |hiːp| - stos
composure  |kəmˈpoʊʒər| - opanowanie
lose (lost) my composure
pierce  |pɪrs| - przeniknąć
tug at  |tʌɡ| - pociągnąć za /
slip into - wszybko wstawić coś
face was expressionless
went into the bathroom
shove  |ʃʌv| - pchnąć
Are you following me so far? - roz o czym mówię?
My guess is that
quiver  |ˈkwɪvər| - trząść się, dygotać, drżeć
intend to  |ɪnˈtend| - planować, zamierzać \
abnormal - nienormalne \
vigorously  |ˈvɪɡərəsli| - energicznie
crush sb  |krʌʃ| - zmiażdżyć kogoś / 
taser  - 
check up on sb - sprawdzać kogoś
complain  |kəmˈpleɪn| - narzekać
vestige  |ˈvestɪdʒ| - ślad
dim - idiota,
he is pretty dim — он изрядный тупица
dont be so dim
have control over smth
have power over me - władzę nade mną
right away
at best — w najleprzym przypadku
bundle of keys  |ˈbʌndl| - wiązka, pakunek, plik, węzełek
ashamed  |əˈʃeɪmd| - zawstydzony
clash with - gryźć się ze sobą
the pound sign #

10/05/2020
deny  |dɪˈnaɪ| - odmówić \
draw/drew attention - przyciągac uwagę
be off - pójśc sobie \
mind sb - przejmować się kimś \
evict  |ɪˈvɪkt| - rugować ((1.1) usuwać kogoś z zajmowanego miejsca)
evicted  |ɪˈvɪktəd| - 
find out about - dowiedzieć sie o 
be in trouble \
place in - pomieścić do
suspicious  |səˈspɪʃəs| - nieufny \
hung up the phone - odłożyć słuchawkę \
call off the encounter with sb - odwołać
greet  |ɡriːt| - powitać, pozdrowić kogoś
died  |ˈdaɪd| - zmarł
at the moment - w tym momencie
role  |roʊl| - rola
head for the door - kierować się w stronę
acquire  |əˈkwaɪər| - uzyskiwać
libel  |ˈlaɪbl| - zniesławienie
we have not done thus far - do tej pory
on that subject - na ten temat
frown  |fraʊn| - zmarszczyć brwi
bit  |bɪt| - zrobić kąs
prosecute for  |ˈprɑːsɪkjuːt| - wnieść oskarżenie przeciwko
spotlight  |ˈspɑːtlaɪt| - reflektor, silne światło punktowe
begin (began) with - zaczynać się od 
shirt  |ʃɜːrt| - koszula
candid  |ˈkændɪd| - szczery
prompt  |prɑːmpt| - spowodować
what prompted that - co spowodowało to że ????
to run it into the ground = zabić
boycott  |ˈbɔɪkɑːt| - bojkot
organize  |ˈɔːrɡənaɪz| - organizować
to silence  |ˈsaɪləns| - uciszyć
inmate  |ˈɪnmeɪt| - więzień
cell  |sel| - cela
attitude  |ˈætɪtuːd| - podejście
towards - w stosunku do
choose |tʃuːz| - chose |tʃoʊz| - chosen |ˈtʃoʊzn|
apparent  |əˈpærənt| - oczywisty
Precisely because - Właśnie dlatego, że
disarm  |dɪsˈɑːrm| - rozbroić
stifle  |ˈstaɪfl| - stłumić
to stifle the impulse
be asleep - spać \
conclude the agreement with - zawrzeć umowę
they argued  |ˈɑːrɡjuːd| - oni kłócili się

bunk  |bʌŋk| - koja na statku, łóżko w wagonie sypialnym, prycza
cramp  |kræmp| - skurcz
be no more or less than - to nic innego jak
corresponding to - analogiczny do, porównywalny do\
costly  |ˈkɔːstli| - kosztowny
fundamentally  |ˌfʌndəˈmentəli| - zasadniczo, zdecydowanie
change the situation fundamentally
grim  |ɡrɪm| - srogi, surowy, bez litości, niewyrozumiały
make me aware - 
be on shaky ground
Up until now - do tej pory 

hold with something - zgadzać się z czymś \
I don't hold with that \
spit it out - wypluć, "powiedzić "
turn away from sb - odwrócić się od kogoś
to lit a cigarette
undress - rozebrać się \
climb  |klaɪm| - wzrastać
The temperature will climb next week.
climb into bed
claim in a credible way - wiarygodny
insinuate  |ɪnˈsɪnjueɪt| - insynuować, sugerować
deal dealt  |delt| with smth - poradzić z 
warden  |ˈwɔːrdn| - strażnik, stróż [COUNTABLE]
lend (lent) the status - nadawać status 
lend == borrow
followed by — с последующим
followed by painting — с последующим окрашиванием
ado  |əˈduː| -  kłopot
much ado about nothing — много шума из ничего
grant  |ɡrænt| - udzielić coś, dotacja
request was granted without further ado
unhealthy  |ʌnˈhelθi| - niezdrowy
sleeve  |sliːv| - rękaw

obtain  |əbˈteɪn| - otrzymywać, uzyskiwać
plane |pleɪn| - płaszczyzna
In order to obtain this result, 
we need to modify the way 
\left(x,y\right) is represented.
goes beyond the scope of this tutorial
critisize
satisfied
in other words - innymi slowy 
first things first — spoczątku o głównym
collectively - ogólnie
generally speaking

24/05/2020
ask for permission
ado  |əˈduː| - kłopot
so that - tak żeby
cabinet  |ˈkæbɪnət| - szafka
Not that any of the inmates would have stolen it - nie to żeby oni ukradliby
not that - nie to żeby \
In this way - w taki sposób
one of whom - jeden z których \
have roots in - mieć korzenia w (family)
family  |ˈfæməli| - rodzina
recreation  |ˌriːkriˈeɪʃn| - wypoczynek
passable  |ˈpæsəbl| - dostateczny
summon sb |ˈsʌmən| - wezwać kogoś
But I have no milk yet - póki co
unpack bags
on terminal
be on holiday
absurd  |əbˈsɜːrd| - bzdura
buy groceries \
get home - przyjść do domu
find (found) out - dowiedzieć się 
I was just about to eat
holes and gaps
stand in for somebody - zastępować kogoś \(np. w pracy)
wry  |raɪ| - krzywy, skrzywiony \
perk up - ożywiać się
interrupt  |ˌɪntəˈrʌpt| - przerwać coś \
particularly  |pərˈtɪkjələrli| - szczególnie
she wasn’t particularly glad to see him
stiffen  |ˈstɪfn| - zesztywnieć
sort out - uporządkować coś
- put in order
attitude towards me - stosunek do mnie
larger  |ˈlɑːrdʒər| - większy
brew  |bruː| - zaparzyć
majority of  |məˈdʒɔːrəti| - większość \
- balk of
absent-minded - nieuważny
flit - przemieszczać się szybko
as though - jak gdyby
thought flitted through his head, as though - jak gdyby
You were gone, as though you had never existed - jak gdyby
you took me by surprise - zaskoczyłeś mnie \
whom I met when - którego spotkałam \
miserable  |ˈmɪzrəbl| -  przygnębiony \
I didn’t mean to, but it happened - zamierzać
temporarily  |ˌtempəˈrerəli| - tymczasowo \
take stock - rozważać szczegółowo 
for good - na zawsze \
decide on - zdecydować się na coś \
dropped the jacket on the floor
barge in - wparować do \
Cecilia appeared embarrassed - zażenowana \
ludicrous - absurdalny, śmieszny
delight |dɪˈlaɪt| - zachwyt 
delighted  |dɪˈlaɪtɪd| - zachwycony \
scarcely  |ˈskersli| - ledwo \
- barely
conceal  |kənˈsiːl| - ukryć, zataić

Henrik could scarcely conceal his delight - Henrik ledwo mógł ukryć swój zachwyt.

assure  |əˈʃʊr| - zapewniać
I assure you that it will be safe - \ zapewmnić kogoś \

be pissed off - być wkurzonym \
criticise  |ˈkrɪtɪsaɪz| - krytykować
At first I thought it was just luck - z początku \
presume  |prɪˈzuːm| - przypuszczać  \
forward  |ˈfɔːrwərd| - do przodu
take us forward - posuwać się do przodu
246

senseless  |ˈsensləs| - bezsensowny \
undertaking  |ˌʌndərˈteɪkɪŋ| - akcja \
on the matter - na ten temat
scrutinise |ˈskruːtənaɪz| - szczegółowo badać
settle over something - zapaść nad czymś, zawisnąć nad czymś
blush  |blʌʃ| - rumienić się 
put on some coffee
blossom  |ˈblɑːsəm| - kwitnąć \
so to say - że tak powiem \
snippet
route  |raut| - trasa \
Prior or after - przed albo po \
duplicate  |ˈduːplɪkeɪt| - duplikat
switch sides \

somebody  |ˈsʌmbədi| - ktoś
be mean to smb — czepiać się do kokoś
mean to me
birch  |bɜːrtʃ| - [bot.] brzoza
cabin  |ˈkæbɪn| - domek
lush  |lʌʃ| -  soczysty, bujny, bujnie rosnący
managed to catch Martin - udało się złapać
stuff the lunch in the rucksack
village  |ˈvɪlɪdʒ| - wioska
marvellous  |ˈmɑːrvələs| - cudowny
marina  |məˈriːnə| - mały port dla jachtów
porch  |pɔːrtʃ| - ganek
neglected  |nɪˈɡlektɪd| - zaniedbany \
flake off - łuszczyć się
scythe  |saɪð| - kosa
unscrew  |ˌʌnˈskruː| - odśrubować
shutter  |ˈʃʌtər| - okiennica
facing the water - z widokiem na wodę
beneath  |bɪˈniːθ| - poniżej, pod czymś
die, died, dead
bureau  |ˈbjʊroʊ| - biuro
sketchpad  - szkicownik
and the like - i tym podobne
rake  |reɪk| - grabie
go to the dogs - pogorszyć się
retreat to the place |rɪˈtriːt| - wycofać się do 
wretched  |ˈretʃɪd| - nieszczęśliwy, biedny, żałosny, nędzny
misery  |ˈmɪzəri| - nędza, skrajne ubóstwo
skirt  |skɜːrt| - unikać czegoś \
importunate  |ɪmˈpɔːrtʃənət| - dokuczliwy
cogitation  |ˌkɑːdʒɪˈteɪʃn| - zastanawianie

252
right yourself - wyprostować siebie
miscellaneous  |ˌmɪsəˈleɪniəs| - różnoraki
uncover  |ʌnˈkʌvər| - odsłonić
germinate  |ˈdʒɜːrmɪneɪt| - kiełkować (    (1.1) wyrastając, wypuszczać kiełki – drobne pędy)
what had been germinating in the back of his mind
in back of his mind — в глубине его сознания
feel confused  |kənˈfjuːzd| - zdezorientowany
sorrowful  |ˈsɑːroʊfl| - bolesny
reminder  |rɪˈmaɪndər| - przypomnienie
spectator  |ˈspekteɪtər| - widz \
subconscious  |ˌsʌbˈkɑːnʃəs| - podświadomość
subconsciously  - podświadomie
in vicinity  |vəˈsɪnəti| - w pobliżu
frightened  |ˈfraɪtnd| - przestraszony
taking up his time - zabierać czas
brood about - rozmyślać o 
to frighten her - przestraszyć
consciously  |ˈkɑːnʃəsli| - świadonie
taciturn  |ˈtæsɪtɜːrn| - milczący
dubious  |ˈduːbiəs| - wątpący
arrange by date - uporządkować
brood about = dumać, rozmyślać, rozpamiętywać coś
back then - wtedy \
Everything was so simple back then.
On the day of the parade
he lacked - nie miał
in vain - na próżno \

discern  |dɪˈsɜːrn| - dostrzec
get the point - rzozumieć
dismay  |dɪsˈmeɪ| - niepokój
reckon  |ˈrekən| - uważać że 
reckoned  |ˈrekənd|
the time passed - czas upłynął
sorrow  |ˈsɑːroʊ| - smutek
trace - ślad 
simultaneously  |ˌsɪmlˈteɪnɪəsli| - jednocześnie
downhearted and exhilarated - przygnębiony i zachwycony
shed (shed) the light on smth = rzucać światło (ułatwiać zrozumienie)  = make it clear
relentlessly |ri'lentlessli|  - nieustannie
errand  |ˈerənd| - polecenie, sprawunek
banquet  |ˈbæŋkwɪt| - bankiet, uczta
long  |lɔːŋ| - długi(o)
length  |leŋθ| - długość
lengthen  |ˈleŋθən| - przedłużyć
broad  |brɔːd| - szeroki \
hitherto  |ˌhɪðərˈtuː| - dotąd, dotychczas
wrestle  with |ˈresl| -  walczyć z 
He slapped his forehead - czoło
enlarge the image |ɪnˈlɑːrdʒ| - powiększać
heart  |hɑːrt| - serce
pluck out  - wyrwać 
get hold of = to grab
snapshot  |ˈsnæpʃɑːt| - fotografia, zdjęcie
take a picture
- photograph
- image
- snap
fuzzy  |ˈfʌzi| - rozmyty
to spot - zauważyć 
spotted  |ˈspɑːtɪd|
emerge  from |iˈmɜːrdʒ| - wyłaniać się z czegoś 
 venture out something - zaryzykować wyjście z czegoś 
he’s ventured out
quote, Your whore isn’t home, unquote.
measure - zmierzyć coś
skull  |skʌl| - czaszka
be  in his right mind - być w zdrowym rozsądku
presumably  |prɪˈzuːməbli| - prawdopodobnie
we sort of - tak jakby
put smth on hold = postpone
266

come along - robić postępy
pour  |pɔːr| - nalać
turn up - znaleźć \
You’ve turned up something completely new
For a fraction of a second I thought - przez chwilę  ...
where did you spring from? - wziąć się skądś
Broadly speaking - ogólnie mówiąc \
be on my way to - być w drodzę do 
You should have given me some warning so I could buy some good food or something.
get lost
pastry  |ˈpeɪstri| - kruche ciasto
(most) assuredly  |əˈʃʊrədli| - z pewnością
I am no longer - już nie jestem \
Not at all - wcale nie 
to brag about the fact that - pochwalić się 
unfairly - niesprawiedliwie \
they were alike - podobne \

put it out of your mind
do not confuse love with lust 
take a break
perform actions on it
get started
presedence
bind a value to the variavle
for now thouth 
as soon as you press - jak tylko naciśniesz
memorize  |ˈmeməraɪz| - zapamiętywać
omit  |əˈmɪt| -  pomijać














