NOUN
gaol / jail |dʒeɪl| - więzienie
wind  |wɪnd| - wiatr
objective  |əbˈdʒektɪv| - cel
government  |ˈɡʌvərnmənt| - rząd
height  |haɪt| - wysokość
crook  |krʊk| - oszust
trial  |ˈtraɪəl| - proces w sądzie
court  |kɔːrt| - sąd
judgement  |ˈdʒʌdʒmənt| - wyrok
verdict  |ˈvɜːrdɪkt| - wyrok
appeal  |əˈpiːl| - apelacja, odwołanie
dye  |daɪ| - farba
prison  |ˈprɪzn| - więzienie
promises  |ˈprɑːməsəz| - obietnicy
commotion  |kəˈmoʊʃn| - zamieszki
scrapbook - album
breakthrough - przełom
victim  |ˈvɪktɪm| - ofiara
murder - morderstwo
spectator  |ˈspekteɪtər| - widz
grief  |ɡriːf| - smutek
divorce |dɪˈvɔːrs| - rozwód małżeństwa

ADJECTIVE
anxious  |ˈæŋkʃəs| - niespokojny
concerned  |kənˈsɜːrnd| - zainteresowany
amused  |əˈmjuːzd| - rozbawiony
convinced  |kənˈvɪnst| - przekonany
persuasive  |pərˈsweɪsɪv| - przekonujący
standalone  - niezależny


IDIOM
drive sb insane - doprowadzić do szału
mince one's words - owijać w bawełnę 
get to the bottom of things - get the truth


THE UNSORTED BUFFER
wened - zanikający, zanikać
she drowned - ona otonęła
fascinated by - zafascynowany czymś
happen to sb - wydarzyć się z kimś
year-round - przez cały rok
pretty much so - całkiem sporo
killed Harriet and hid the body
To tell you the truth
within the realm of possibility - w granicach możliwości
missing - zaginiona
a great number of  - wiele
the overturned tanker truck
an unpleasant person
suspect - podejrzany
wait a very short while
a very short while
as far as we could determine - o ile nam się udało ustalić
in the picture I could see that
lie to sb about smth - kłamać komuś
it could have been done
strike, struke
be committed a crime - popełnić przestępstwo
drive across the bridge
to sum things up - podsumować
I want to nail the swine - przybić
nearby - obok
and searching for the truth began to affect my work - wpływać na
on the contrary - przeciwnie / nawet odwrotnie
sail knots - zarządzać, wiązać węzły
ponder smth - zastanawiać się
obsessed with it - mieć obsesję na punkcie czegoś
move on with my presentation
102
burden - obciążenie
to be left alone
be aware - być świadomy czegoś
to bury her - pogrzebać
buried - pochowany
before my story is done - skończyć
expressly - wyraźnie
to get a vehicle of my own - ... swój własny
bike is locked in a cellar - piwnica
Sooner or later, she thought, I have to
You only pop in when you need something - pojawiać się
As usual - jak zawsze
weighed 330 pounds
The place smelled stuffy - duszny
He gave her smile
the street light beyond the window
she handed him five thousand kronor - przekazać
laid a box on the table
once more - po raz kolejny
sometime during the summer ??
Precisely - dokładnie
at long last - wrzeszcie
he recognised that - przyznać?
back of a chair
whe hang jacket over the back of a chair
paper basket
potted plant - w doniczce
the first time
deposite in the basket - wyrzucić do kosza
she visited  the office no more than - nie częściej niż
he insisted - nalegać
His reasoning was that - jego powód był taki że
keep an eye on her - pilnować kogoś
She suspected that - podejrzewać że coś tam
this way he would have a chance - w taki sposób
meddle in her affairs - wtrącać się w sprawy
a lip - warga
feel bored - czuć się znudzonym
After a while - nieco później
nonexistent - nieistniejący
chences was almost nonexistent - nikłe szansy
she had taken the trouble ???
I refuse to go to my grave - odmawiam pójścia do
commission you to - zlecićc ci coś
evidence - dowód
one last time - po raz ostatni
to conjure up a solution to a mistery - wyczarować rozwiązanie
he has drawn up a contract - sporządzić umowę
negotiate the details
all it needs is - wsztstko czego potrzebujemy to
All it asks is - wszystko co jest wymagane to 
absurd
sighed - wzdychać
he relented - zaufał????
to set aside my life - poczekać z życiem osobistym
devote time
devote myself to smth - poświęcać siebie na
as to your career - a co do twojej 
for the monent - w tej chwili
be on hold - ???
astonished - zdziwiony
but if against all odds - wbrew wszystkim szansom
crack the mistery
generous - hojny, szczedry
report the income - about taxes
Why so? - dlaczego tak?
that has plagued me - drenczy mnir
make attempt - spróbować
I owe it to Harriet - być winnym komuś
defeat in court - porażka w sądzie
put the suitcase by the door - obok
as if you’re slinking off with your tail between your legs
precisely |prɪˈsaɪsli| - dokładnie
to do some gaol time ???
beginning of the end
facing him ??
sat at the kitchen table
take a stand - ?
they could not agree
damned - cholernie
give up on smth (millenium)
be burned out - być wyczerpanym
take a job in a circus - cyrk
sink smth for good - na zawsze
He’s paranoid as far as I’m concerned. ???
set out in detail what he knows
111
willing - chętny
evidence - dowód
The thought had crossed my mind - przyszła mi do głowy
at the time she disappeared - w czasie gdy
you’re grasping at straws - chwytasz się za słomki
it’s a rotten situation - fatalna
I’m so fucking angry with you
baseless - bezpodwstawny
I have to fight him alone
but what makes me so cross is that - zdenerwowany??
dumping this decision on sb
As far as Dahlman is concerned
get back - wrócić
What I’m afraid of is that  - to czego się obawiam to
wake up, woke up sb - obudzić kogoś
drunk with sleep
put in much time  - devote much time 
hung up the thelephone - odłożyć słuchawkę
violence - przemoc
been subjected to violence by a man
He suddenly felt lonely and uncertain
lodgings - zakwaterowanie???
a small timbered house - drewniany
with a sigh of relief - ulga + westchnienie
to light the fire - zapalić ogień
woodstove - piec drewny
it gets bitterly cold
a firewood bin
a woodshed
sufficient - wystarczający
landscape painting
storeroom had been converted into a bathroom with a shower
cold hangs on for long - zatrzymać się na długo
the day after tomorrow
very next day he would go ????
an excuse for - pretekst
at any rate - w każdym razie
The police checked his alibi
He was frozen to the bone
On second glance - na drugi rzut oka
trudged through - przebijać się przez
120
bob@bobthecanadian.com
care for each other - dbać o 
I find him detestable - obrzydliwy
defend him - brobić 
being related is no guarantee of love
have much in common - mieć wiele wspólnego
occasionally - from time to time
be capable - być zdolnym
take initiative
take responsibility - wziąć odpowiedzialność
she just wasn’t capable of taking responsibility - być zdolnym do
he and she separated
have regard - mieć szacunek
She suffers from - cierpi na coś
and with that - i wraz z tym
be over - skończyć się
and as of now - i od teraz
a breach of contract - naruszenie?
have a discussion = to discuss
albeit - aczkolwiek
at some stage - w pewnym momencie
get settled - zaaklimatyzować się
buy some groceries
by the time - do czasu kiedy coś zrobił
It was after 4:00 by the time Blomkvist was done.
His teeth were chattering by the time he got indoors
get indoors - wejść przez wrzwi
barely - ledwo
pantry - spiżarnia
the temperature dropped to -1
fill paper bags to overflowing - do pełna
the only customer - jedyny klient
He was [for the time being] - na nazie / póki co
a loaf of bread - bochenek chleba
by the name of - o nazwie
ascertaine - ustalić
fell asleep
awake to to utter silence - absolutna cisza
fill (fell) rested - czuć się odpoczentym
exile - wygnanie
carrying out his plan - realizować plan
carry out plan
go shopping in town
rucksack - plecak
a sponge cake - biszkopt
She began to object - sprzeciwiać się 
greet them - przywitać ich
memory feiled him - zawodzić
stay on briefly - zostać na mały czas
What was clear was that - było jasne to że
what is clear is that
no doubt - bez wątpienia
129
plausible |ˈplɔːzəbl| - prawdopodobny
scrapbook - photograph album
diary |ˈdaɪəri| - pamiętnik
he heard a loud meowing
swiftly |ˈswɪftli| - szybko
pour |pɔːr| - nalać
he poured |ˈpɔːrd| - nalał 
a dish - naczynie
ball |bɔːl| - piłka
the cat curls up into a ball when she sleeps
he make himself sandwiches
he was uninterested in food
be uninterested in smth - nie interesować się czymś
he wrote down who lived in each house
he walked across the bridge - przejść przez most
all of a sudden - suddenly
He could not for the life of him understand - wcale nie mógł zrozomieć
she talk him into taking this task - namówić do zrobienia czegoś
resolutly - zdecydowanie
familiarising himself with - zapoznać siebie z czymś
assault |əˈsɔːlt| - napad
He stuck his notebook into his bag
whereabouts |ˈwerəbaʊts| - miejsce pobytu
133
talk in turn with sb - rozmawiać po kolei z sb
in turn - po kolei
he came to the conclusion - dojść do wniosku
estate - osiedle?
be able to
he was able to
provide no information
solely |ˈsoʊlli| - tylko po to, by
She appeared to have insisted on meeting - wygląda na to?
on the list of suspects - na liście
at present - w tej chwili / w chwili obecnej
a study - gabinet
earlier |ˈɝːliər| - wcześniej
in the day - w ciągu dnia?
to state |steɪt| - oświadczać, ogłaszać
to state - stwierdzić
Greger Vanger stated that - ogłosił
merely given her a greeting - tylko ...
give sb a greeting - greet sb
he expressed the view that - wyraził opinię na coś
thoughtlessly - bezmyślnie
confide in sb - zwierzyć się komuś
erroneously - błędnie
have opportunity - mieć możliwość
she felt ineasy - czuć się nieswojo
and that it was not like?
to go off without telling
tell the family - powiedzić rodzinie
men and women of varying ages
the unoccupied houses - wolny
The latter was searched because - ten ostatni był 
put forward the theory
But the search was fruitless - bezowocny
set up his headquarters - założyć coś gdzieś
a drawing room - salon? dlacego tak się nazywa?
a number of - szereg czegoś
and tried to ascertain |ˌæsərˈteɪn|  - wstalić
somethig is missing - czegoś jest brak
...or the like - etc / or so / lub to dego podobne
be helful, she had not been helpful - nie było pomocna
handkerchief - chusteczka do nosa
summone |ˈsʌmən| - wezwać
to interview sb, sb is interviewed
appealed for help - prosić o pomoc?
confusion - zamieszanie
turn of events - obrót wydarzeń
unquestionably - niewiątpliwie
plaque  |plæk| - płytka, płyta, tablica

on that day - w tamtym dniu
on the contrary - wręcz przeciwnie
on the plaque - na tablice (coś było nalisane)
on these holidays - w te święta
on the following day - następnego dnia
at the right moment - w pasujący moment
on the island - na wyspie
at the estate - na osiedlu
at the right moment - w pasujący moment
at the house - w domu

discount |ˈdɪskaʊnt| - nie brać pod uwagę, pominąć, odrzucić
discount possibility - odrzucić możliwość
increasingly likely that - coraz bardziej prawdopodobnie
as far as - o ile
as far as Blomkvist could tell - o ile on mówił powiedzić
apparently  |əˈpærəntli| - najwyraźniej
search the waters  - przeszukać wody
abandoned bunker |əˈbændənd| - porzucony
attic |ˈætɪk| - strych
cellar  |ˈselər| - piwnica
vegetable cellars - piwnice
puzzled  |ˈpʌzld| - zdziwiony
He was puzzled - zdziwiony
reach for the door handle
Even as he reached for the door handle - właśnie w tym momencie kiedy
notice the likeness - podobieństwo
Blomkvist hesitated before telling the truth - wahał się
hesitate  |ˈhezɪteɪt| - wahać się
I can’t pretend that - udawać
go to preason - serve in preason
anyway - tak czy inaczej
it’s never engage in a fight you’re sure to lose
on the brass plaque - tablica
plaque |plæk| - tablica

guesswork - zgadywanie
to deal with - mieć do czynienia?
conscious |ˈkɑːnʃəs| - przytomny
conscious+ness |ˈkɑːnʃəsnəs| - świadomość
composure - |kəmˈpoʊʒər| opanowanie
consider - brać pod uwagę
a debt  |det| - dług, zadłużenie
debts  |ˈdets| - dług wobec
intently  |ɪnˈtentli| - uważnie
predecessor |ˈpredəsesər| - poprzednik
guardian |ˈɡɑːrdiən|  - strażnik
guardianship |ˈɡɑːrdiənʃɪp| - opieka
she was under social guardianship - być pod soc. opieką
fill (felt) uncomfortable
have a stroke
violent  |ˈvaɪələnt| - brutalny
classmate  |ˈklæsmeɪt| - kolega/koleżanka z klasy
violent towards her classmates - agresywny wobec swoich koleżanek i kolegów z klasy
to participate in |pɑːrˈtɪsɪpeɪt| - uczestniczyć w 
to lift a pen to write anything - podnieść
by the time she was thirteen - kiedy ...
after all - w końcu  / finally
foster  |ˈfɔːstər| - wspierać kogoś w czymś
a foster family - rodzina zastępcza
end up in - wylądowąć gdzieś / okazać się gdzieś
emergency  |iˈmɜːrdʒənsi| - nagły przypadek
she ended up in the emergency room - trafiła na pogotowie
she was under the influence of narcotics
claim  |kleɪm| - twierdzić
Salander claimed that - she stated that / twierdziła że
grope  |ɡroʊp| - omacywać
the man had groped her - obmacywał ją
fold  |foʊld| - zgiąć
with her arms folded - ze złożonymi ramionami
conclusion |kənˈkluːʒn| - wniosek
come to the conclusion - dojść do wniosku
she had come to the conclusion that - doszła do wniosku że 
come to the decision - zdecydowąć się
the court would come to any decision other than - niż ...
bring, brought from - przenieść z ...
she was brought from ... to ... - była przeniesiona z ... do ...
she listened intently - uważnie słuchała
he was conscious but unable to speak or move 
call for an ambulance - dzwonić po pogotowie
she called for an ambulance
to explain the gravity of the situation - powagę wytuacji
every action has its consequences
truancy from school - wagarowanie szkoły
The only time - jedyny raz kiedy 
she had been charged with assault and battery ????
to take charge of - do przejęcia odpowiedzialności za
right after - odrazu po tym jak
to take pity on him - zlitować się nad nim
She considered herself in his debt - uważała siebie za 
unrenovated - niewyremontowany
it was a roof over her head
Not even ... or ... - ani ... ani ... - nawet... ???
disassemble  |ˌdɪsəˈsembl| - rozbierać na części
impact  |ˈɪmpækt| - wpływ
nearby  |ˌnɪrˈbaɪ| - w pobliżu
147


147, 02-03-2020

the apartment was shabby - niechlujny
no way + she would - nie ma szans
Prior to the meeting with Bjurman - przed spotkaniem
affair |əˈfer| - sprawa
take care of my own affairs
and she was supposed to report - miała się zgłosić
and such like - i podobne
modest - skromny
This has to do with the fact that - ma to związek z
smth has to do with - coś ma związek z czymś
be responsible for - być odpowiedzialnym za 
This has to do with the fact that - odruchowo
dities as work - obowiązki w pracy
remind himself - przypomnieć sobie
Vanger was convinced, for his part, that - był przekonany, ze swojej strony
the assignment was beyond all common sense - poza wszelkim
That was the gist of - sedno

140
refuse to participate in - odmawiać uczestniczenia w
take care of smth or sb - zadbać o smth or sb
look after sb - opiekować się
difficult |ˈdɪfɪkəlt| - trydny
in spite of a difficult start - wbrew 
gradually |ˈɡrædʒuəli| - z czasem / stopniowo
modest |ˈmɑːdɪst| - skromny
a modest amount of - skromna ilość
ease back |iːz bak| - przesunąć się powoli i ostrożnie do tyłu 
eased back into
by way of a foster family - w drodze do
have the effect - mieć efekt
This threat had the effect that - groźba, pogróżka
be intoxicated
witnesses - świadkowie
hand down an opinion - wydać opinię
the outcome - the result / the upshot
and it was unlikely that - małoprawdopodobne że
it took a while for her to realise that
scrutinised - przeanalizowany
warrant - gwarancja
145

appearance - |əˈpɪrəns| wygląd
scheduled - zaplanowany
corridor |ˈkɔːrɪdɔːr| - korytarz
go in the door
go out the door
take into the room
consciousness |ˈkɑːnʃəsnəs| - przytomność
to regain consciousness - odzyskać
she nether wept nor ... - ani ani
she stood up
summon to the meeting with smb - wezwać kogoś
how things were doing
how are you doing?
the tie and tiepin - krawat i 
to judge by - sądząc po
he offers tee and chats with her
during the years - w ciągu tych lat
not even ... or ..had ever .. his ... - nawet
he lives the one block away
so as - tak aby
how he got away with it - udać się
be responsible for sb
she was supposed to report it - miała
to possess - posiadać
light upon |əˈpɑːn| smb - natknąć się na kogoś
he might light upon her killer
he was convinced - był przekonany
accusation |ˌækjuˈzeɪʃn| - oskarżenie
he was forced to create - był zmuszony
purchase |ˈpɜːrtʃəs| - nabyć coś

151
fight (fought) |fɔːt| - walczyć
fought like cats - walczyli jak koty
in some ways - w pewnym sensie
a hint - odrobina
a hint of a smile
leave something out - pominąć coś, opuścić coś
convince  |kənˈvɪns| - przekonać
conviction  |kənˈvɪkʃn| - przekonanie
to share sb's conviction that - dzielić z kimś pogląd na
long for  - tęsknić za
He longed for his own bed - tęsknić za
awoken  |əˈwoʊkən| - obudzony
be awoken by sb - być obudzonym przez sb
worth  |wɜːrθ| - warty
be worth a visit - być wartym
what he was working on - nad czym on pracuje
urge  |ɜːrdʒ| - namówić do
Susanne urged him - namówiła
gossip - plotka
and sashayed off to the kitchen
lung disease
drown (drowned) - utonąć
no one was divorced or remarried
spouse - współmałżonek
die died

apparently  |əˈpærəntli| - najwyraźniej
descendant |dɪˈsendənt| - potomek
descendants - potomkowie
peculiarity |pɪˌkjuːliˈærəti| - ciekawostka
The other peculiarity was that - inną ciekawostką było to że
and thereby - i tym samym
make sober assessment - zrobić ocenę
children reached the age of sixteen
punishment - kara
accomplishments - osiągnięcia
career
follow smb's footsteps - pójść w ślady
physician
race - rasa
in other respects - w innych kwestiach
invincible, undefeatable - niepokonany
wagons were destined - przeznaczone
contact sb
beg sb |beɡ| - błagać sb
wildly beautiful woman
presume  |prɪˈzuːm| - przypuszczać
an ultimatum—either he accepted our marriage or he’d have to look for
military  |ˈmɪləteri| - wojskowy
do military service - służyć w wojsku
At times he was on the brink - zasami był na krawędzi
folly  |ˈfɑːli| - szaleństwo, głupota
have a look at smth - spojrzeć na coś

