//////////////////////////////////////////
21 * xxxx
//////////////////////////////////////////
Obviously a woman brought him coffee shortly before he died.
we arrived shortly before six o'clock
what it does? (co to robi?)
Put your coat on, otherwise (a inaczej) you'll get cold
we would have to (musielibyśmy)
I'd have to go past her apartment, but her door is always open
relax, she didn't go past your house (jechać obok, mijać)
I wish to be left alone (chcę żeby pozostawiono mnie w spokoju)
my father can't be left alone for any length of time
which directory am I in? (be in)
and your mother, incidentally, is wrong
anyone who says otherwise is selling something. (Każdy, kto twierdzi inaczej, próbuje ci coś wmówić)

died  |ˈdaɪd| - zmarł
obviously  |ˈɑːbviəsli| - oczywiście
cold  |koʊld| - zimno
get cold - przyziębić się
be wrong |rɔːŋ| - mylić się
incident  |ˈɪnsɪdənt| - wydarzenie, incydent, zajście
incidentally  |ˌɪnsɪˈdentli| - notabene, nawiasem mówiąc
shortly before - tuż przed / krótko przed
be sorry - żałować
list smth - wymienić
basically  |ˈbeɪsɪkli| - w zasadzie
probably  |ˈprɑːbəbli| - prawdopodobnie
talk to - porozmawiać z
she left home - ona wyszła z domu
price for - cena za
pay for - płacić za
cancel  |ˈkænsl| - anulować
approach  |əˈproʊtʃ| - zbliżać się
careful  |ˈkerfl| - ostrożny
while + ing - podczas
suitcase  |ˈsuːtkeɪs| - walizka
enquire  |ɪnˈkwaɪər| - dowiedzieć się
away  |əˈweɪ| - w oddaleniu, w odległości
away from - na odległości od
be away from smth - być na odległości od czegoś
go up - wchodzić po 
go down - schodzić po
a walk  |wɔːk| - spacer, przechadzka
walk (over) - podejść do kogoś lub czegoś
be late
shelf / rack  |ræk| - półka
every other day - co drugi dzień
join  |dʒɔɪn| - dołączyć się
jointed them  |ˌdʒɔɪntəd| - dołączyli się do nich
excited about |ɪkˈsaɪtɪd| - podniecony, podekscytowany
as ... - kiedy ...
after + present simple - po tym jak
they are about to ... - szykują się do tego, żeby ...
take away - zabrać kogoś dokądź
make smb - kazać komuś
don't make me - nie każ mi
word |wɜːrd| - słowo
like I am - jak ja
be up to date - być aktualnym
hammer |ˈhæmər| - młotek, uderzać, uderzać/wbijać młotkiem