rapidly  |ˈræpɪdli| - szybko
slightly  |ˈslaɪtli| - trochę
assume - zakładać
assumption  |əˈsʌmpʃn| - założenie, przypuszczenie
link - odnośnik
couse smth - spowodować coś
concern sb - dotyczyć kogoś
care about - martwić się z powodu czegoś
duty  |ˈduːti| - obowiązek
mock  |mɑːk| - symulować
things go accoring to my plan
yield  |jiːld| - dawać (w efekcie)
in other words - innymi słowy
register - rejestrować
analyse |ˈænəlˌɑɪz| - analizować
initial - początkowy
capture  |ˈkæptʃər| - łapać
a tool that captures and analyzes packets 
colon  |ˈkoʊlən| - dwukropek
turn out that - okazać się że
come out that - okazać się że
it turned out that - okazało się że
at the moment - w tym momencie
take up (a lot of space) - zajmować
cycle  |ˈsaɪkl| - cykl
command  |kəˈmænd| - polecenie
comment  |ˈkɑːment| - komentarz
determine  |dɪˈtɜːrmɪn| - określać
newly |ˈnuːli| - najnowszy
zeroed  |ˈzɪəroʊd| - wyzerowany
laboratory  |ˈlæbrətɔːri| - laboratorium
provide  |prəˈvaɪd| - dostarczać
configure  |kənˈfɪɡjər| - konfigurować
actualize  |ˈæktʃuəlaɪz| - aktualizować
pass arguments to - przekazać do
neither ... nor - ani ... ani ...
hand over to - przekazać do
collect |kəˈlekt| - zbierać, kolekcjonować
collect from - odebrać od
in accordance with - zgodnie z 
alias  |ˈeɪliəs| - przezwisko
clone into
unlike with - w przeciwieństwie do
in contrast to - w przeciwieństwie do
employee - pracownik
injection  |ɪnˈdʒekʃn| - zastrzyk
installed  |ˌɪnˈstɒld| - zainstalowany
images  |ˈɪmədʒəz| - obrazy
remind me later - przypomnij mi później
deprecate |ˈdeprəkeɪt| - uznawać za niewłaściwe
via  |ˈvaɪə| - przez, za pośrednictwem
retrieve |rɪˈtriːv| - odzyskać, odnaleźć
populate  |ˈpɑːpjuleɪt| - zaludnić
plenty  |ˈplenti| - mnóstwo
handle - uchwyt
(dust)bin - pojemnik na śmiecie
chart  |tʃɑːrt| - wykres
chapter  |ˈtʃæptər| - rozdział (książki)
utilize  |ˈjuːtəlaɪz| - wykorzystywać
empty - opróżnić (kosz)
empty - pusty
tear down - zniszczyć, zburzyć (np. dom)
agenda  |əˈdʒendə| - ustalony plan jakiegoś spotkania
major  |ˈmeɪdʒər| - ważny, znaczny
stay tuned - czekać na dalsze informacje / nie zmieniać stacji 
slave  |sleɪv| - niewolnik
bright  |braɪt| - jaskrawy
brightness  |ˈbraɪtnəs| - jasność
upload - załadować
summary - strzeszczenie
entry  |ˈentri| - wpis
exited  |ˈeksɪtɪd| - wyszedł
verify  |ˈverɪfaɪ| - weryfikować
given - określony
guess - domyślić się
practically  |ˈpræktɪkli| - niemal
satisfied  |ˈsætɪsfaɪd| - zadowolony
be pleased - być zadowolonym
be satisfied - być zadowolonym
be certain - być pewnym
pod - strąk
verifying  |ˈverəˌfaɪɪŋ|
proceed |proʊˈsiːd| - kontynuować (działanie)
proceed |proʊˈsiːd| - zabrać się za coś
storey  |ˈstɔːri| / floor - piętro
probably  |ˈprɑːbəbli| - prawdopodobnie
fund  |fʌnd| - fundusz
envy  |ˈenvi| - zazdrość, zawiść
envy sb - zazdrościć
certain  |ˈsɜːrtn| - określony
refuse to |rɪˈfjuːz| - odmawiać w
verbose  |vɜːrˈboʊs| - gadatliwy
crucial  |ˈkruːʃl| - kluczowy
explicitly  |ɪkˈsplɪsɪtli| - jawnie
identation - wcięcie / a space at the beginning of a line
exceed  |ɪkˈsiːd| - przekraczać
efficient  |ɪˈfɪʃnt| - wydajny
augment  |ɔːɡˈment| - zwiększać
mismatch  |ˌmɪsˈmætʃ| - rozbieżność
discard / reject  |rɪˈdʒekt| - odrzucać

