abort  |əˈbɔːrt| - przerwać
missing  |ˈmɪsɪŋ| - brakujący
the missing file
occur |əˈkɜːr| - wydarzyć się
occurred  |əˈkɝːd| - wydarzyło się
assert  |əˈsɜːrt| - stwierdzać
assertion  |əˈsɜːrʃn| - twierdzenie
sign in - zalogować się
sign out - wylogować się
log out - wylogować się
resign  |rɪˈzaɪn| - rezygnować
failure  |ˈfeɪljər| - niepowodzenie
failures  |ˈfeɪljəz| - niepowodzenia
fatal  |ˈfeɪtl| - śmiertelny
fatal failure
I failed  - nie powiodło mi się 
installed  |ˌɪnˈstɒld| - zainstalowany
cut off / truncate  |ˈtrʌŋkeɪt| - odciąć
dash  |dæʃ| - pozioma kreska
contact smb - skontaktować się z
words  |ˈwɝːdz|
sail  |seɪl| - żeglować (statek)
publish  |ˈpʌblɪʃ| - publikować
length  |leŋθ| - długość
at minimum - przynajmniej
since - z tego powodu że
time unit - jednostka czasu
to vote  |voʊt| - głosować
the vote  |voʊt| - głos
guide  |ɡaɪd| - przewodnik
the order  |ˈɔːrdər| - zamówienie
deploy  |dɪˈplɔɪ| - wdrażać
deployment  |dɪˈplɔɪmənt| - wdrożenie
the reply  |rɪˈplaɪ| - odpowiedź
article  |ˈɑːrtɪkl| - artykuł
advanced  |ədˈvænst| - zaawansowany
advanced scripts
retry, retries 
maintain  |meɪnˈteɪn| - utrzymywać
causes  |ˈkɑːzəz| - przyczyny
issue  |ˈɪʃuː| - kwestia, sprawa, problem
achieve  |əˈtʃiːv| - osiągać
achievement  |əˈtʃiːvmənt| - osiągnięcie
achieved  |əˈtʃiːvd| - osiągnął
***********************************************
exited  |ˈeksɪtɪd| - wyszedł
verbose  |vɜːrˈboʊs| - gadatliwy
satisfied  |ˈsætɪsfaɪd| - zadowolony
indeed  |ɪnˈdiːd| - rzeczywiście
images  |ˈɪmədʒəz| - obrazy
unsatisfactory  - niezadowalający
stay tuned - следите за новостями
verify  |ˈverɪfaɪ| - weryfikować
verifying  |ˈverəˌfaɪɪŋ|
in favor of - na korzyść
unlike with - w przeciwieństwie do
reveal  |rɪˈviːl| - ujawnić
tear down - zniszczyć, zburzyć (np. dom)
guess - domyślić się
you have probably guessed - domyśliłeś się
in other words - innymi słowy
empty - opróżnić (kosz)
utilize  |ˈjuːtəlaɪz| - wykorzystywać
bin - pojemnik na śmiecie
given - określony
certain  |ˈsɜːrtn| - określony
yield  |jiːld| - dawać (w efekcie)
perfectly  |ˈpɜːrfɪktli| - doskonale
actualize  |ˈæktʃuəlaɪz| - aktualizować
clone into
summary - strzeszczenie
fund  |fʌnd| - fundusz
succeed  |səkˈsiːd| - powieść się
plenty  |ˈplenti| - mnóstwo
in fact - w rzeczywistości
essentially  |ɪˈsenʃəli| - w zasadzie
timely  |ˈtaɪmli| - na czas
practically  |ˈpræktɪkli| - praktycznie, niemal
succeed  |səkˈsiːd| - powieść się
it succeeds  |səkˈsiːdz| - powodzi się
obtain  |əbˈteɪn| - uzyskać
refuse to |rɪˈfjuːz| - odmawiać w
estimate  |ˈestɪmət| - oszacować
abandon  |əˈbændən| - porzucić
readily  |ˈredɪli| - z łatwością
crucial  |ˈkruːʃl| - kluczowy
compose  |kəmˈpoʊz| - komponować
it succeeded  |səkˈsiːdəd| - powiodło się
correspond  |ˌkɔːrəˈspɑːnd| - prowadzić korespondencję
it causes to happen - podowuje że się zdarza
queued  |kjuːd| - kolejkowany
credentials |krəˈdenʃlz| - tożsamość
denote (by yellow) |dɪˈnoʊt| - oznaczać czymś
proceed  |proʊˈsiːd| - trwać, toczyć się
continue  |kənˈtɪnjuː| - kontynuować
continues  |kənˈtɪnjuːz|
continuing  |kənˈtɪnjuːɪŋ|
pass arguments to 
be failing  |ˈfeɪlɪŋ| - kraszować się 
assume - zakładać
contribute  |kənˈtrɪbjuːt| - wnosić wkład
proceed  |proʊˈsiːd| - kontyniować
toggle  |ˈtɑːɡl| - przełącznik
configure  |kənˈfɪɡjər| - konfigurować
suite  |swiːt| - komplet
slightly  |ˈslaɪtli| = a bit - trochę
automate  |ˈɔːtəmeɪt| - automatyczny
cluster  |ˈklʌstər| - kiść
pod - strąk / owoc pojedynczy, suchy pękający
slave  |sleɪv| - niewolnik
thief  |θiːf| - złodziej
replica  |ˈreplɪkə| - kopia
replicas  |ˈrepləkəz| - kopie
disadvantage  |ˌdɪsədˈvæntɪdʒ| - minus
rejoice  |rɪˈdʒɔɪs| - cieszyć się, radować się
confuse  |kənˈfjuːz| - mylić, nie rozróżniać
expose  |ɪkˈspoʊz| - ujawniać, wywieszać
complex  |kəmˈpleks| - złożony
conjunction  |kənˈdʒʌŋkʃn| - połączenie
retrieval  |rɪˈtriːvl| - odzyskanie
delivered  |dəˈlɪvərd| - ostarczony
supplied  |səˈplaɪd| - dostarczony
snooze  |snuːz| - drzemka
index - spis alfabetyczny
accordance  |əˈkɔːrdns| - zgodność
in accordance with - zgodnie z 
proceed |proʊˈsiːd| - kontynuować (działanie)
per day - dzienne
lock and unlock
newly - najnowszy
concern - dotyczyć
employee - pracownik
lose - stracić
confluence of - połączenie czegoś
accordingly  |əˈkɔːrdɪŋli| - odpowiednio, stosownie
preliminary  |prɪˈlɪmɪneri| - wstępny
agility  |əˈdʒɪləti| - zręczność, zwinność
significantly  |sɪɡˈnɪfɪkəntli| - znacznie
accelerate  |əkˈseləreɪt| - przyspieszać
distinguish ... from ... |dɪˈstɪŋɡwɪʃ| - rozróżniać
namely  |ˈneɪmli| - mianowicie
dismiss  |dɪsˈmɪs| - odrzucić
discard / reject  |rɪˈdʒekt| - odrzucać
interact  |ˌɪntərˈækt| - utrzymywać stosunki
distribute  |dɪˈstrɪbjuːt| - rozprowadzić
configure  |kənˈfɪɡjər| - konfiguracja
privilege  |ˈprɪvəlɪdʒ| - przywilej
privileges  |ˈprɪvlədʒəz| - przywileje
grant - przyznać coś czymś
pending  |ˈpendɪŋ| - toczący się
recapture  |ˌriːˈkæptʃər| - odzyskać
compose  |kəmˈpoʊz| - komponować, tworzyć
consistency  |kənˈsɪstənsi| - spójność
variety of |vəˈraɪəti| - różnorodność
provide  |prəˈvaɪd| - dostarczać
thus  |ðʌs| - i tak, stąd
cycle  |ˈsaɪkl| - cykl
beware  |bɪˈwer| -  strzec się
term  |tɜːrm| - termin
confusion  |kənˈfjuːʒn| - niejasność
whereas  |ˌwerˈæz| - podczas gdy
corresponds to - jest odpowiednikiem do 
commonly  |ˈkɑːmənli| - powszechnie
resemble smth |rɪˈzembl| - być podobnym do
followed by - a następnie
comment  |ˈkɑːment| - komentarz
further  |ˈfɜːrðər| - późniejszy
unfinished  |ʌnˈfɪnɪʃt| - nie dokończony
implement  |ˈɪmplɪment| - wprowadzić w czyn
proper  |ˈprɑːpər| - prawidłowy
conference  |ˈkɑːnfərəns| - konferencja
fair  |fer| - targ
approve  |əˈpruːv| - zatwierdzać
approval  |əˈpruːvl| - zatwierdzenie
expense  |ɪkˈspens| - koszt
command  |kəˈmænd| - polecenie
comment  |ˈkɑːment| - komentarz
determine  |dɪˈtɜːrmɪn| - określać
patch  |pætʃ| - łata (fragment materiału przyszyty do tkaniny)
commitment  |kəˈmɪtmənt| - zobowiązanie
discontinue  |ˌdɪskənˈtɪnjuː| - zaprzestać, zakończyć działalność
assess  |əˈses| - oceniać
particular  |pərˈtɪkjələr| - konkretny
return from |rɪˈtɜːrn| - wrócić z 
returned from |rəˈtɝːnd| - wrócił z
questions  |ˈkwestʃənz| - pytania
in this particular case - w tym przypadku
suitable  |ˈsuːtəbl| - pasujący
for all of you - dla każdego z was
corresponding  |ˌkɔːrəˈspɑːndɪŋ| - odpowiedni
attempt  |əˈtempt| - próbować
evaluate  |ɪˈvæljueɪt| - oceniać
rounding  |ˈraʊndɪŋ| - okrąglenie liczby
in the same way - tak samo
the same - ten sam
do you mind? - nie masz nic przeciwko?
remind me later - przypomnij mi później
ordinary  |ˈɔːrdneri| - zwykły
along with - wraz z 
determine  |dɪˈtɜːrmɪn| - określać
handle - uchwyt





























