realm  |relm| - królestwo
unless |ənˈles| - chyba, że
nonetheless  |ˌnʌnðəˈles| - tak czy owak
urge  |ɜːrdʒ| - zachęcać
abandon  |əˈbændən| - porzucić
surprise  |sərˈpraɪz| - zaskakiwać
ruin  |ˈruːɪn| - niszczyć
rewind  |ˌriːˈwaɪnd| - przewinąć do tyłu
utilize  |ˈjuːtəlaɪz| - wykorzystywać
rejoice  |rɪˈdʒɔɪs| - radować się
confluence of - połączenie czegoś
proceed  |proʊˈsiːd| - kontynuować
approve  |əˈpruːv| - zatwierdzać coś
snore  |snɔːr| - chrapać
manage smth - poradzić sobie z 
deal with smth - poradzić sobie z 
handle smth - poradzić sobie z 
watch out for - uważać na
be familiar with smth - znać coś
be mistaken - być w błędzie
mistaken - mylny
foolish - niemądry
freed  |ˈfriːd| - wyzwolony
withdraw - wycofać się
efficient  |ɪˈfɪʃnt| - wydajny
approved - zatwierdzony
needed - potrzebny
node  |noʊd| - węzeł
coverage  |ˈkʌvərɪdʒ| - zasięg
thief  |θiːf| - złodziej
survey  |ˈsɜːrveɪ| - badanie
cluster  |ˈklʌstər| - kiść
difficulty  |ˈdɪfɪkəlti| - uciążliwość
explicitly  |ɪkˈsplɪsɪtli| - wyraźnie
estimate  |ˈestɪmət| - oszacować
process  |ˈprɑːses| - przetwarzać (plik) (zmieniać, nadając inne właściwości) /  przekształcać
lock and unlock
per day - dzienne
discouraged  |dɪsˈkɜːrɪdʒd| - zniechęcony
participate  |pɑːrˈtɪsɪpeɪt| - uczestniczyć
pretend  |prɪˈtend| - udawać
preserve  |prɪˈzɜːrv| - ochronić
exchange data with - wymieniać się danymi z
maintain  |meɪnˈteɪn| - utrzymywać
issue  |ˈɪʃuː| - kwestia, sprawa, problem
achieve  |əˈtʃiːv| - osiągać
achieved  |əˈtʃiːvd| - osiągnąłem
achievement  |əˈtʃiːvmənt| - osiągnięcie
secure  |səˈkjʊr| - bezpieczny
garbage  |ˈɡɑːrbɪdʒ| - [am.] śmieci
lose (lost) - stracić
get lost - zgubić się 
dangle  |ˈdæŋɡl| - wisieć
dangled |ˈdæŋɡəld| - zawieszony
capability  |ˌkeɪpəˈbɪləti| - możliwość
capabilities  |ˌkepəˈbɪlətiz| - możliwości
opaque  |oʊˈpeɪk| - nieprzejrzysty
you have probably guessed - domyśliłeś się
at some point - w którymś momencie 
it would be better - byłoby lepiej
mess up - narobić bałaganu
fall down, fell down - spaść na coś
bear |ber| - znosić coś, cierpieć coś, tolerować coś 
laughter  |ˈlæftər| - śmiech
begin anew - zacząć od nowa
each time / every time - za każdym razem gdy
comment  |ˈkɑːment| - komentować
authorities  |əˈθɔːrətiz| - władze
awful  |ˈɔːfl| - obrzydliwy
at some point - w kŧórymś momencie
snore  |snɔːr| - chrapać
quiet  |ˈkwaɪət| - cichy
eager  |ˈiːɡər| - podekscytowany
mismatch  |ˌmɪsˈmætʃ| - rozbieżność
discard / reject  |rɪˈdʒekt| - odrzucać
velocity  |vəˈlɑːsəti| - prędkość
essential  |ɪˈsenʃl| - podstawowy, zasadniczy
processed  |ˈprəʊsest| - przetwarzyłem
indeed  |ɪnˈdiːd| - rzeczywiście
unsatisfactory  - niezadowalający
in favor of |ˈfeɪvər| - na korzyść
perfectly  |ˈpɜːrfɪktli| - doskonale
essentially  |ɪˈsenʃəli| - w zasadzie
timely  |ˈtaɪmli| - w pasujący moment
obtain  |əbˈteɪn| - uzyskać
compose  |kəmˈpoʊz| - komponować
correspond  |ˌkɔːrəˈspɑːnd| - prowadzić korespondencję
it causes to happen - podowuje że się zdarza
queued  |kjuːd| - kolejkowany
credentials |krəˈdenʃlz| - tożsamość
denote (by yellow) |dɪˈnoʊt| - oznaczać czymś
contribute  |kənˈtrɪbjuːt| - wnosić wkład
toggle  |ˈtɑːɡl| - przełącznik
suite  |swiːt| - komplet
automate  |ˈɔːtəmeɪt| - automatyczny
disadvantage  |ˌdɪsədˈvæntɪdʒ| - minus
confuse  |kənˈfjuːz| - mylić coś z czymś
expose  |ɪkˈspoʊz| - ujawniać
complex  |kəmˈpleks| - złożony
conjunction  |kənˈdʒʌŋkʃn| - połączenie


******************************************************
retrieval  |rɪˈtriːvl| - odzyskanie
delivered  |dəˈlɪvərd| - dostarczony
supplied  |səˈplaɪd| - dostarczony
snooze  |snuːz| - drzemka
index - spis alfabetyczny
accordance  |əˈkɔːrdns| - zgodność
accordingly  |əˈkɔːrdɪŋli| - odpowiednio, stosownie
preliminary  |prɪˈlɪmɪneri| - wstępny
agility  |əˈdʒɪləti| - zręczność, zwinność
accelerate  |əkˈseləreɪt| - przyspieszać
distinguish ... from ... |dɪˈstɪŋɡwɪʃ| - rozróżniać
namely  |ˈneɪmli| - mianowicie
dismiss  |dɪsˈmɪs| - odrzucić
interact  |ˌɪntərˈækt| - utrzymywać stosunki
appliance  |əˈplaɪəns| - urządzenie
distribute  |dɪˈstrɪbjuːt| - rozprowadzić
configure  |kənˈfɪɡjər| - konfiguracja
privilege  |ˈprɪvəlɪdʒ| - przywilej
privileges  |ˈprɪvlədʒəz| - przywileje
grant - przyznać coś czymś
pending  |ˈpendɪŋ| - toczący się
recapture  |ˌriːˈkæptʃər| - odzyskać
compose  |kəmˈpoʊz| - komponować, tworzyć
consistency  |kənˈsɪstənsi| - spójność
variety of |vəˈraɪəti| - różnorodność
thus  |ðʌs| - i tak, stąd
beware  |bɪˈwer| -  strzec się
term  |tɜːrm| - termin
confusion  |kənˈfjuːʒn| - niejasność
whereas  |ˌwerˈæz| - podczas gdy
corresponds to - jest odpowiednikiem do 
commonly  |ˈkɑːmənli| - powszechnie
resemble smth |rɪˈzembl| - być podobnym do
followed by - a następnie
comment  |ˈkɑːment| - komentarz
further  |ˈfɜːrðər| - późniejszy
unfinished  |ʌnˈfɪnɪʃt| - nie dokończony
implement  |ˈɪmplɪment| - wprowadzić w czyn
proper  |ˈprɑːpər| - prawidłowy
conference  |ˈkɑːnfərəns| - konferencja
fair  |fer| - targ
approve  |əˈpruːv| - zatwierdzać
approval  |əˈpruːvl| - zatwierdzenie
expense  |ɪkˈspens| - koszt
patch  |pætʃ| - łata (fragment materiału przyszyty do tkaniny)
commitment  |kəˈmɪtmənt| - zobowiązanie
bourne  |ˈbɔːrn| - urodzony
discontinue  |ˌdɪskənˈtɪnjuː| - zaprzestać, zakończyć działalność
assess  |əˈses| - oceniać
particular  |pərˈtɪkjələr| - konkretny
return from |rɪˈtɜːrn| - wrócić z 
returned from |rəˈtɝːnd| - wrócił z
questions  |ˈkwestʃənz| - pytania
in this particular case - w tym przypadku
suitable  |ˈsuːtəbl| - pasujący
for all of you - dla każdego z was
corresponding  |ˌkɔːrəˈspɑːndɪŋ| - odpowiedni
attempt  |əˈtempt| - próbować
evaluate  |ɪˈvæljueɪt| - oceniać
rounding  |ˈraʊndɪŋ| - okrąglenie liczby
the same - ten sam
in the same way - tak samo
do you mind? - nie masz nic przeciwko?
determine  |dɪˈtɜːrmɪn| - określać
ordinary  |ˈɔːrdneri| - zwykły
reveal  |rɪˈviːl| - ujawnić
as a rule of thumb |θʌm|  - z reguły 
substitute  |ˈsʌbstɪtuːt| - zastępować
superior  |suːˈpɪriər| - przełożony
along with - wraz z 
supervisor  |ˈsuːpərvaɪzər| - kierownik, nadzorca
infinite  |ˈɪnfɪnət| - nieskończony
honestly  |ˈɑːnɪstli| - szczerze
resume  |rɪˈzuːm| - wznowić
scenario  |səˈnærioʊ| - scenariusz
warn smb  |wɔːrn| - ostrzec
attempt  |əˈtempt| - próbować
interestingly  |ˈɪntrəstɪŋli| - co ciekawe
attic  |ˈætɪk| - strych / mansarda
stamp  |stæmp| - pieczęć
column  |ˈkɑːləm| - kolumna
intact  |ɪnˈtækt| - nienaruszony
alternative  |ɔːlˈtɜːrnətɪv| - alternatywa
coverage  |ˈkʌvərɪdʒ| - pokrycie
priority  |praɪˈɔːrəti| - priorytet
priorities  |praˈjɔːrətiz| - priorytety
snap  |snæp| - fotografia (najczęściej amatorska), zdjęcie
environment  |ɪnˈvaɪrənmənt| - środowisko
machine  |məˈʃiːn| - maszyna
status  |ˈsteɪtəs| - status
resolution  |ˌrezəˈluːʃn| - rozwiązanie
event  |ɪˈvent| - przypadek, zdarzenie
register  |ˈredʒɪstər| - rejestrować
mock  |mɑːk| - udawany, nieprawdziwy
survey  |ˈsɜːrveɪ| - badanie
whistle  |ˈwɪsl| - gwizd
dispatch  |dɪˈspætʃ| - wysłać
excellence  |ˈeksələns| - doskonałość, znakomitość
abbreviation  |əˌbriviˈeɪʃən| - skrót
acronym  |ˈækrənɪm| - skrótowiec
distinctive  |dɪˈstɪŋktɪv| - charakterystyczny
delimit  by |diˈlɪmɪt| - ustanawiać granice
also delimited by double quotes
obligatory  |əˈblɪɡətɔːri| - obowiązkowy
class definition -> class implementetion
prohibit  |prəˈhɪbɪt| - zakazywać
facilitate  |fəˈsɪlɪteɪt| - ułatwiać
legal in |ˈliːɡl| - dopuszczalny w 
conditional statement
further  |ˈfɜːrðər| - dodatkowy
with - za pomocą
suppress  |səˈpres| - stłumić
be prefixed - poprzedzić coś czymś
consist of |kənˈsɪst| - składać się z
typically  |ˈtɪpɪkli| - zwykle
letter - literka
lowercase letters
issue a command - wydać rozkaz
the file located on the file system
recognize  |ˈrekəɡnaɪz| - rozpoznać, uznać za
recognizing  |ˈrekəgˌnaɪzɪŋ|
recognized  |ˈrekəgˌnaɪzd| - uznany za
repeatedly  |rɪˈpiːtɪdli| - wielokrotnie
token  |ˈtoʊkən| - symboliczny
followed by - po którym następuje
asterisk  |ˈæstərɪsk| - gwiazdka
simultaneously  |ˌsɪmlˈteɪnɪəsli| - jednocześnie
underlying  |ˌʌndərˈlaɪɪŋ| - podstawowy
be responsible for - być odpowiedzilnym za
spawn  |spɔːn| -  powodować, płodzić
shark  |ʃɑːrk| - [zool.] rekin
ignored  |ɪgˈnɔːrd| - ignorowany
skip - pomijać
zone  |zoʊn| - strefa
exclamation mark - wykrzyknik
subject  |ˈsʌbdʒɪkt| - temat (wiadomości na przykład)
particular  |pərˈtɪkjələr| - szczególny
morph  |mɔːrf| - forma, postać
accomplish  |əˈkɑːmplɪʃ| - wykonać
photo  |ˈfoʊtoʊ| - zdjęcie
picture  |ˈpɪktʃər| - obraz
image  |ˈɪmɪdʒ| - obraz, zdjęcie
figure  |ˈfɪɡjər| - zdjęcie
arbitrarily  |ˌɑːrbəˈtrerəli| - losowo
range between - wachać się pomiędzy
appropriate  |əˈproʊpriət| - właściwy
stretch  |stretʃ| - rozciągnąć
stretched or squashed
width  |wɪdθ| - szerokość
desired  |dɪˈzɑɪərd| - pożądany 
scale  |skeɪl| - zmieniać rozmiar
average  |ˈævərɪdʒ| - średnia
reuse  |ˌriːˈjuːs| - powtórnie wykorzystać
non-negative integer value
distinct  |dɪˈstɪŋkt| - odrębny, różny
underly  |ˌəndərˈlaɪ| - podstawowy, zasadniczy
mail  |meɪl| - wysyłać pocztą
wipe  |waɪp| - wytrzeć
terminate  |ˈtɜːrmeɪt| - zakończyć
packages  |ˈpækədʒəz| - pakiety
layer  |ˈleier| - warstwa
region  |ˈriːdʒən| - region
evaluate  |ɪˈvæljueɪt| - oceniać
numbered  |ˈnʌmbr̩d| - ponumerowany
cursor  |ˈkɜːrsər| 
append  |əˈpend| - dołączać, załączać
monitor  |ˈmɑːnɪtər| - monitor
content  |ˈkɑːntent| - treść, zawartość
be gone - zniknąć
establish  |ɪˈstæblɪʃ| - nawiązać (połączenie)
trace  |treɪs| - lokalizować, namierzać
minus  |ˈmaɪnəs| - minus
processes  |ˈproʊsesɪz| - procesy
equation  |ɪˈkweɪʒn| - [mat.] równanie
symbol  |ˈsɪmbl| - symbol
condition  |kənˈdɪʃn| - warunek
parameter  |pəˈræmɪtər| - parametr
transparent  |trænsˈpærənt| - przejrzysty
used  |juːst| - używany
be used - służyć
is used to - służy do
hit  |hɪt| - nacisnąć
digit  |ˈdɪdʒɪt| - cyfra
backward  |ˈbækwərd| - wsteczny
refer  |rɪˈfɜːr| - odnosić się
browse  |braʊz| - [inf.] przeglądać
besides / apart of |əˈpɑːrt| - oprócz
cut off - odciąć
trigger  |ˈtrɪɡər| - wywołać coś
give and take away - dać i zabrać
slide  |slaɪd| - slajd, osuwanie się 
exclude  |ɪkˈskluːd| - wyłączać, wykluczyć
disconnect  |ˌdɪskəˈnekt| - odłączać
column  |ˈkɑːləm| - kolumna
columns  |ˈkɑːləmz| - kolumny
remote  |rɪˈmoʊt| - zdalny
I received  |rəˈsiːvd| - dostałem
suspend  |səˈspend| - zawieszać
bottom  |ˈbɑːtəm| - dno, spód
continue  |kənˈtɪnjuː| - kontynuować
continuing  |kənˈtɪnjuːɪŋ| - kontynuacja
maintenance  |ˈmeɪntənəns| - utrzymanie, konserwacja
persist  |pərˈsɪst| - upierać się przy czymś, obstawać, nie ustawać
remain  |rɪˈmeɪn| - pozostawać
customize  |ˈkʌstəmaɪz| - dostosowywać do potrzeb
adjust - dostosowywać
dangle  |ˈdæŋɡl| - zwisać, wisieć
unspecified  |ˌʌnˈspesɪfaɪd| - nieokreślony
lookup  - przegląd
go ahead - iść naprzód
disappear  |ˌdɪsəˈpɪr| - znikać
instantly  |ˈɪnstəntli| - niezwłocznie
person and people
dependence  |dɪˈpendəns| - zależność
dependencies  |dəˈpendənsiz| - zależności
restrict  |rɪˈstrɪkt| - ograniczać
wide  |waɪd| - szeroki
split  |splɪt| - podzielić
squeeze  |skwiːz| - scisnąć
omit  |əˈmɪt| - pomijać
schedule  |ˈskedʒuːl| - planować, harmonogram
junior  |ˈdʒuːniər| - młodszy
senior  |ˈsiːniər| - starszy
sort by  - sortować po
middle  |ˈmɪdl| - środek
turn off - wyłączyć
identifier  |aɪˈdentɪfaɪər| - identyfikator
anything  |ˈeniθɪŋ| - coś (w zdaniach pytających i przeczących)
anythig but - wszystko za wyjątkiem
digit  |ˈdɪdʒɪt| - cyfra
except  |ɪkˈsept| - z wyjątkiem, z zastrzeżeniem
underscore  |ˌʌndərˈskɔːr| - znak podkreślenia
separate |ˈseprət| - rozdzielać
equal  |ˈiːkwəl| - równy
care for - dbać o

make executable
assume that |əˈsuːm| - zakładać, że
at the beginning of - na początku
run a script prepend ./ to the filename
it is suggested that - propunuje się żeby
specifically for |spɪˈsɪfɪkli| - specjalnie dla
deem  |diːm| - uważać za coś
appropriate  |əˈproʊpriət| - stosowny, właściwy
deem appropriate - uważać za potrzebne
dependable  |dɪˈpendəbl| - niezawodny
claim  |kleɪm| - żądać
here is an explanation for each line
either in ... or in ... - albo w ... albo w 
highly recommended - bardzo polecane
blank  |blæŋk| - pusty
using - za pomocą
copy into - skopiować do
preceding  |priˈsiːdɪŋ| - uprzedni
precede  |prɪˈsiːd| - poprzedzać
one time - jeden raz
more useful  |ˈjuːsfl| - więcej przydatnego
statement  |ˈsteɪtmənt| - oświadczenie / polecenie
lines 6 through 9 are executed
explanation  |ˌekspləˈneɪʃn| - objaśnienie
determine  |dɪˈtɜːrmɪn| - ustalać coś
perform  |pərˈfɔːrm| - wykonywać
performed on - wykonane nad
various  |ˈveriəs| - różny
be passed to |ˈpæst| - być przekazanym do
it was passed to - to było przekazane do
handle  |ˈhændl| - obchodzić się z
embed |ɪmˈbed| - wbudowywać
indent  |ɪnˈdent| - wcięcie
exit  |ˈeksɪt| - wyjście
failure  |ˈfeɪljər| - niepowodzenie
placeholder - zastępująca metka
quote strings - cytować
validate  |ˈvælɪdeɪt| - sprawdzać ważność
stands for - zastępować
greater than  |ˈɡreɪtər| - większy niż
less than - mniejszy niż
the negation operator - negacja 
affect the output - wpływać na wyjście
reminder  |rɪˈmaɪndər| - przypomnienie
negate  |nɪˈɡeɪt| - negować
clarification  |ˌklærəfɪˈkeɪʃn| - wyjaśnienie
attempt  |əˈtempt| - próba
the shorthand way of doing - krótszy sposób na to żeby
get a feel for - wczuć się w coś, jakiś proces
change some of the values
quantity  |ˈkwɑːntəti| - ilość
handy  |ˈhændi| - zręczny
suppose  |səˈpoʊz| - przypuszczać
bracket  |ˈbrækɪt| - nawias
showed  |ʃoʊd| - pokazał
nested loop
nest  |nest| - gniazdo
consult  |kənˈsʌlt| - wprawdzić w
continues  |kənˈtɪnjuːz| - wykonuje się
encounter  |ɪnˈkaʊntər| - napotykać, stykać się
eventually  |ɪˈventʃuəli| - ostatecznie
the inner  |ˈɪnər| - wewnętrzny
approaches  |əˈproʊtʃɪz| - zbliża się
investigate  |ɪnˈvestɪɡeɪt| - badać, ustalać
scheme  |skiːm| - harmonogram
particular  |pərˈtɪkjələr| - dany
foreground  |ˈfɔːrɡraʊnd| - pierwszy plan
caused by |ˈkɑːzd| - spowodowane 