honesty  |ˈɑːnəsti| - uczciwość
dishearten  |dɪsˈhɑːrtn| - zniechęcać
cease  |siːs| - przestać
interrupt  |ˌɪntəˈrʌpt| - przeszkadzać
strip down - rozebrać się
engage attention - przyciągać uwagę
drown  |draʊn| - tonąć
barren  |ˈbærən| - bezpłodny
don't pay attention - nie zwracaj uwagę
blame smb - winić kogoś
can - puszka
presumably  |prɪˈzuːməbli| - prawdopodobnie
hospitable  |hɑːˈspɪtəbl| - gościnny
tough  |tʌf| - niebezpieczny
thanks in advance
in short - w skrócie mówiąc 
scientist  |ˈsaɪəntɪst| - naukowiec
mighty  |ˈmaɪti| - ogromny
strong temptation - silna pokusa
resist the temptation
coverage  |ˈkʌvərɪdʒ| - zasięg
hostile  |ˈhɑːstl| - wrogi
shore  |ʃɔːr| - brzeg
aground  |əˈɡraʊnd| - mielizna
run aground - osiąść na mieliznę
mundane  |mʌnˈdeɪn| - nieciekawy
measure  |ˈmeʒər| - mierzyć
attempt  |əˈtempt| - próba
setback  |ˈsetbæk| - komplikacja
marsh  |mɑːrʃ| - błoto
lawn  |lɔːn| - trawnik
afterwards  |ˈæftərwərdz| - później
soon afterwards
cove  |koʊv| - zatoczka
proceed  |proʊˈsiːd| - kontynuować
be mistaken  |mɪˈsteɪkən| -  być w błędzie
conclude  |kənˈkluːd| - wywnioskować
prom - bal
lush  |lʌʃ| - bujny, bujnie rosnący
head up - kierować
briefly  |ˈbriːfli| - zwięźle
luckless  |ˈlʌkləs| - niefortunny
a trifle - troszeczkę
bulk of   |bʌlk| - większość
temptation  |tempˈteɪʃn| - pokusa
account - raport
alas  |əˈlæs| - niestety
appellation  |ˌæpəˈleɪʃn| - nazwa
ashore  |əˈʃɔːr| - na ląd
woeful  |ˈwoʊfl| - załamany
a lot - grupa ludzi

I couldn't resist the temptation to buy it.
He has moved abroad for various reasons. (On przeprowadził się za granicę z różnych powodów.) 
