PHRASE
ever since - od tej pory
by then - od tego czasu
all in all - ogólnie przecz biorąc
as far as sb is concerned - jeśli chodzi o 
simply - po prostu
in the first place - przede wszystkim
be anything, but - odczuwać wszystko oprócz
be nothing, but - odczuwać nic oprócz
be nothing beside - być niczym w porównaniu do
do nothing more than - nie robić nic innego jak
at the height of - w okresie
even though - mimo że
even as - właśnie wtedy gdy
more or less - mniej lub więcej
in spite of smth - wbrew czemuś
in particular - w szczególności
thereafter - następnie
finally - w końcu
be a trifle - tyle co nic / be nothing
all time - cały czas
get back on my feet - wstać na nogi z powrotem
whatsoever |ˌhwʌtsoʊˈevər̩| -  zupełnie / cokolwiek
above all |əˈbʌv| |ɔːl| - poza tym
as far as - o ile
for once - chociaż ten jeden raz
apart from smth - oprócz
at the time - w tamtym czasie
be over the moon about - być w siódmym niebie
from beginning to end - od początku do końca
be in vain - na próżno / it was all in vain
for a time - na jakiś czas
once in a while - raz na jakiś czas
wholly  |ˈhoʊlli| - całkowicie
altogether  |ˌɔːltəˈɡeðər| - całkowicie
extremely  |ɪkˈstriːmli| - bardzo
thereby  |ˌðerˈbaɪ| - w ten sposób
presumably  |prɪˈzuːməbli| - prawdopodobnie
along with - razem z
evidently  |ˈevɪdəntli| - najwyraźniej
smth have nothing to do with - to nie ma nic wspólnego z
naturally  |ˈnætʃrəli| - oczywiście
what matters about smth is that - w tym zajściu jest ważne to że
there is no reason - nie ma powodu
there is no doubt that - nie ma wątpliwości co do tego że
nevertheless  |ˌnevərðəˈles| - niemniej jednak
on the contrary - wręcz przeciwnie
instantly - right away, natychmiast
obviously  |ˈɑːbviəsli| - oczywiście

ADJECTIVE
anxious  |ˈæŋkʃəs| - niespokojny
concerned  |kənˈsɜːrnd| - zainteresowany
amused  |əˈmjuːzd| - rozbawiony

NOUN
wind  |wɪnd| - wiatr
objective  |əbˈdʒektɪv| - cel
government  |ˈɡʌvərnmənt| - rząd
height  |haɪt| - wysokość
crook  |krʊk| - oszust
trial  |ˈtraɪəl| - proces w sądzie
court  |kɔːrt| - sąd
judgement  |ˈdʒʌdʒmənt| - wyrok
verdict  |ˈvɜːrdɪkt| - wyrok
gaol  |dʒeɪl| - areszt tymczasowy
appeal  |əˈpiːl| - apelacja, odwołanie
dye  |daɪ| - farba
prison  |ˈprɪzn| - więzienie
promises  |ˈprɑːməsəz| - obietny

VERB
drive sb insane - doprowadzić do szału
make sence - mieć sens
it makes sence - to ma sens
feel the need to - mieć potrzebę
exchange glances - wymienić spojrzenia
look to something - liczyć na coś
separate one from two  |ˈseprət| - oddzielić jeden od drugiego
dye  |daɪ| - farbować
look up - wyszukiwać
dub  |dʌb| - nadać przezwisko / nickname
make sb look - przyciągać sb uwagę
suspect sb to being a robber |səˈspekt| - podejrzewać sb w czymś
force sb |fɔːrs| - zmuszać sb
detest  |dɪˈtest| - nienawidzić
appeal  |əˈpiːl| - apelować
persuade  |pərˈsweɪd| - przekonać
put up - zatrzymać się gdzieś
acquire  |əˈkwaɪər| - zdobyć (informacje)
look after sb - opiekować się sb
irritate  |ˈɪrɪteɪt| - irytować / annoy
encourage  |ɪnˈkɜːrɪdʒ| - zachęcać
suppose  |səˈpoʊz| - przypuszczać
beat the shit out of sb |biːt| - wybić gówno z sb
take sb under sb wing - wziąć pod skrzydło
smirk at sb  |smɜːrk| - uśmiechać się złoślie do sb
embarrass sb |ɪmˈbærəs| - zawstydzać sb
earn  |ɜːrn| - zarabiać
move the house to - przeprowadzić się do 
motion for sb |ˈmoʊʃn| - dać znak sb
interrupt studies  |ˌɪntəˈrʌpt| - przerywać studia
comlete degree - skończyć studia?
work in the field
serve in military |sɜːrv| - służyć w wojsku
serve in prison - odbywać karę w więzieniu
sail against the wind - nie być jak wszyscy
convince sb |kənˈvɪns| - przekonać sb 
to make an exception - zrobić wyjatek
suspect that |səˈspekt| - podejrzewać że
get along well with smb - być w dobrych stosunkach z
be remarried
regret  the decition |rɪˈɡret| - żałować zrobienia czegoś
left for home
alight at  |əˈlaɪt| - wysiadać w
don't sell yourself short
take the opportunity - skorzystać z możliwości
discipline kids |ˈdɪsəplɪn| - dyscyplinować kids
turn the attention to sb - skierać uwagę w stronę sb
be amused to know |əˈmjuːzd| - rozbawiony wiedzieć że
possess  |pəˈzes| - posiadać
comission sb - dawać zlecenie
dig up - odkopać coś
keep my word = remember promises
be responsible for smth - być odpowiedzialnym za coś
talk somebody into something - namówić kogoś do czegoś 
be perched on knee - siedzieć na kolanach












